12x12
SSSSSSSSSSSS
SC.........S
S.WWWWWWWWVS
SPWH.....W.S
S.W.WWWW.W.S
S.W.W..W.W.S
S.W.W.EWVW.S
S.W.WWWW.W.S
S.WH.....WVS
S.WWWWWWWW.S
SH........MS
SSSSSSSSSSSS