12x12
SSSSSSSSSSSS
SC......W..S
SS..WV.WWW.S
SV..W...W..S
S.WWWWW....S
S...W......S
S...W..HW..S
SVW.....W.BS
SWWWV.WWWWWS
S.W..W..W..S
SE..WWW.W..S
SSSSSSSSSSSS