12x12
SSSSSSSSSSSS
SC.........S
SSSSSSSSSS.S
SH........VS
S...WWWWWWWS
S...W.H...HS
S...W.WWWWWS
S...WVW...HS
S...W.W.WWWS
S.R.WVW.W.HS
SR..W.WVWVES
SSSSSSSSSSSS