17x17
SSSSSSSSSSSSSSSSS
SC..W.H.WM...H..S
S.SWS.SWSWSWSWS.S
S..WWWW...WV....S
SWSWS.S.SWS.S.S.S
SM..W..VWM.....VS
SWSWSWSWSWSWSWSRS
S...WH....W....VS
SWSWSWSWS.S.SWS.S
SB....H..V.H..H.S
S.SWS.SWSWS.S.SWS
S.H..W...H.VW...S
SWS.S.SWSWS.SWS.S
SR.WW...W...MH.RS
SWS.S.S.SWS.SWSWS
S.W.W.WRW.W.W.WES
SSSSSSSSSSSSSSSSS